00000000000000000000
00111111100000000000
00100000100000000000
00100000100000000000
00100000100000000000
00111001100000000000
00001001000000000000
00001001000000000000
00011001100000000000
00010000100000000000
00010000100000000000
00011111100000000000
00000000000000000000
