00000000000000000000000000000000000
00000111111111100000000001111111100
00000100000000100000000001000000100
00000100000000100000000001000000100
00000100000000100000000001000000100
00000100000000100000000001000000100
00000111111011100000000001000000100
00000000001010000000000001011111100
00000000001010000000000001010000000
00000011111011111111111111011100000
00000010000000000000000000000100000
00000010000000000000000000000100000
00000010000000000000000000000100000
00000011111111111111111111111100000
00000000000000000000000000000000000
00000000000000000000000000000000000
