       ┌─┬─┬─┬─┬─────┐   ~
       │ │ │ │ │     │  ~%
       └ ┴ ┴·┴ ┤     │  ~%
                     │ ~%~
        ┌─────┐      │ ~~%
        │     │      │  ~~
        │            │ ~~~
        └─────┴──────┤   ~
                          
                          
